{
    "Type": "Kana",
    "Prefix": true,
    "Henkan": "minus",
    "Muhenkan": "underscore",
    "Katakana": "Shift_R",
    "Key": [
        ["", "", "", ""],
        ["", "", "", ""],
        ["1", "!", "１", "！"],
        ["2", "@", "２", "＠"],
        ["3", "#", "３", "＃"],
        ["4", "$", "４", "＄"],
        ["5", "%", "５", "％"],
        ["6", "^", "６", "＾"],
        ["7", "&", "７", "＆"],
        ["8", "*", "８", "＊"],
        ["9", "(", "９", "（"],
        ["0", ")", "０", "）"],
        ["[", "{", "「", "『"],
        ["]", "}", "」", "』"],
        ["", "", "", ""],
        ["", "", "", ""],
        ["'", "\"", "け", ""],
        [",", "<", "く", "゜"],
        [".", ">", "す", "ひ"],
        ["p", "P", "さ", "ふ"],
        ["y", "Y", "つ", ""],
        ["f", "F", "ぬ", "む"],
        ["g", "G", "お", "え"],
        ["c", "C", "の", "も"],
        ["r", "R", "に", "み"],
        ["l", "L", "ね", "め"],
        ["/", "?", "・", "？"],
        ["=", "+", "＝", "＋"],
        ["", "", "", ""],
        ["", "", "", ""],
        ["a", "A", "は", "や"],
        ["o", "O", "か", "そ"],
        ["e", "E", "し", "せ"],
        ["u", "U", "た", "へ"],
        ["i", "I", "て", "ほ"],
        ["d", "D", "ら", "れ"],
        ["h", "H", "う", "る"],
        ["t", "T", "い", "り"],
        ["n", "N", "゛", "あ"],
        ["s", "S", "な", "ま"],
        ["-", "_", "　", " "],
        ["`", "~", "…", "～"],
        ["", "", "", ""],
        ["\\", "|", "￥", "｜"],
        [";", ":", "よ", "ゆ"],
        ["q", "Q", "き", "ゐ"],
        ["j", "J", "こ", ""],
        ["k", "K", "と", "ゑ"],
        ["x", "X", "ち", " "],
        ["b", "B", "っ", "ろ"],
        ["m", "M", "ん", "ー"],
        ["w", "W", "、", "を"],
        ["v", "V", "。", "わ"],
        ["z", "Z", "・", "？"],
        ["", "", "", ""],
        ["", "", "", ""],
        ["", "", "", ""],
        [" ", " ", "　", "　"]
    ]
}
